6 6 
XXXXXX
XaSXaX
XXaaXX
XaXaaX
XaaXFX
XXXXXX